##########################################
##########                     ###########
####                           ###########                                   #####################
####                           ##################################################################################
####   *                       ###################################################################################
####                           ###################################################################################
####           !!!             ######################################################             ######################################################################
#####################          ###################################################                    ##################################################################
############                   ################################################                           #############################################################
###########                    #####################################                                          ##########################################################
###########                    ################                                                                   ###################################################################
###########                    ###########                                                                             #####################################################################
###########                    ########                                                                                         #################################################################
###########         ###############                                                                                                                        ######################################
###########         #######                                                                                                                                      ################################
###########                                                                              !                                                                          #############################
###########                                                                             !#!                                                                             ######################### 
###########                                                                        ########!                                                                                 ####################
###########                                   #####      ################          ##############                                                                            ####################
###########                         ####                     ########            !!##############                                                                            ####################
###########                                                                     !!###############!!                                                                           ###################
###########          !!!!       !!!!!!!!!!!!!!!!!!!!!!!!!!!!!!!!!!!!!!!!!!!!!!!!###################!!                                                                          ##################
#####################################################################################################!!                                                                        ##################
#############################################################################################################            ######################!!!              !!!            ##################
#############################################################################################################!!        !!##########################################            ##################
###############################################################################################################!!    !!###########################                            ###################
#################################################################################################################!!!!#############################                           ####################
##################################################################################################################################################                         ######################
##################################################################################################################################################               ################################
#################################################################                                     ############################################                      #########################
#################################################################                                                      ###########################                          #####################
#########   #   #################################################                                                      ###########################                          ######################
######      #      ##############################################                                                       ##########################                          #####################
####        #        ############################################                                                       ##########################                          #####################
    #       #       #    #########          #####           #####                                                        #########################                          #####################
     #      #      #     #######            #####           #####                                                        #########################                          #####################
      #           #                         #####           #####                                                         ########################!!                      !!#####################
                                            #####           #####                                                          #########################     ############     #########################
            +                                                                                                                #####################                          #######################
                                                                                                                               ###################                          ######################
         #######                                                                                                                  ################                          #####################
         #     #                            #####           #####                                                                                                           #####################
         #     #                            #####           #####                                                                                                           #####################
         #     #                            #####           #####                                                                                                           #####################
##############################################################################!                                                                                              ####################
###############################################################################!                                                                                             ####################
################################################################################!                         !!!!                                                               ####################
##############################################################################################################                            !!!                                ####################
##################################################################################################################                   #############                           ####################
##################################################################################################################                   #############                           ####################
##################################################################################################################                   #############                           ####################
##################################################################################################################                   #############                           ####################
#################################################################################################################################################################################################
                                          